1111111111
1E00000001
1010010101
1C10010111
1P00000101
1111111111