1111111111
1ECCCCCCC1
1C1CC1C1C1
1C1CC1C111
1PCCCCC101
1111111111